########....########....########
#......#....#......#....#......#
#..@...######......######......#
#..............................#
#..............................#
#......######......######......#
#......#....#......#....#......#
###..###....###..###....###..###
..#..#........#..#........#..#..
..#..#........#..#........#..#..
..#..#........#..#........#..#..
..#..#........#..#........#..#..
###..###....###..###....###..###
#......#....#......#....#......#
#......######......######......#
#..............................#
#..............................#
#......######......######......#
#......#....#......#....#......#
###..###....###..###....###..###
..#..#........#..#........#..#..
..#..#........#..#........#..#..
..#..#........#..#........#..#..
..#..#........#..#........#..#..
###..###....###..###....###..###
#......#....#......#....#......#
#......######......######......#
#..............................#
#..............................#
#......######......######......#
#......#....#......#....#......#
########....########....########