...###
...#.#.####
.#...###..#
##........#
#..#@.....#
#####.....#
..#..#....#
.##.##.#.##
.#......##
.#.....##
.#######