########%%%%########%%%%########
#......#%%%%#......#%%%%#......#
#..@...######......######......#
#..............................#
#..............................#
#......######......######......#
#......#%%%%#......#%%%%#......#
###..###%%%%###..###%%%%###..###
%%#..#%%%%%%%%#..#%%%%%%%%#..#%%
%%#..#%%%%%%%%#..#%%%%%%%%#..#%%
%%#..#%%%%%%%%#..#%%%%%%%%#..#%%
%%#..#%%%%%%%%#..#%%%%%%%%#..#%%
###..###%%%%###..###%%%%###..###
#......#%%%%#......#%%%%#......#
#......######......######......#
#..............................#
#..............................#
#......######......######......#
#......#%%%%#......#%%%%#......#
###..###%%%%###..###%%%%###..###
%%#..#%%%%%%%%#..#%%%%%%%%#..#%%
%%#..#%%%%%%%%#..#%%%%%%%%#..#%%
%%#..#%%%%%%%%#..#%%%%%%%%#..#%%
%%#..#%%%%%%%%#..#%%%%%%%%#..#%%
###..###%%%%###..###%%%%###..###
#......#%%%%#......#%%%%#......#
#......######......######......#
#..............................#
#..............................#
#......######......######......#
#......#%%%%#......#%%%%#......#
########%%%%########%%%%########