...###
..##.#.####
.##..###..#
##..@.....#
#..#.#.#..#
########..#
..#..#....#
.##.##.#.##
.#......##
.#.....##
.#######