########
#......#
#.#..#.#
#..@....
#.......
#.#..#.#
#......#
###..###