########
#......#
#.#..#.#
.......#
.......#
#.#..#.#
#......#
###..###