########
#......#
#..##..#
.......#
.......#
#..##..#
#......#
###..###