########
#......#
#..##..#
#..@....
#.......
#..##..#
#......#
###..###