########
#......#
#......#
#.#@.#..
#.#..#..
#......#
#......#
###..###