########
#......#
#..#...#
#..@....
#...#...
#...#..#
#......#
###..###