###..###
#......#
#..##..#
#.......
#.......
#..##..#
#......#
###..###