###..###
#......#
#..#...#
...#....
....#...
#...#..#
#......#
###..###