###..###
#......#
#......#
#.#..#..
#.#..#..
#......#
#......#
###..###