###..###
#......#
#......#
..#..#.#
..#..#.#
#......#
#......#
###..###