###..###
#......#
#.#..#.#
........
........
#.#..#.#
#......#
###..###