###..###
#......#
#......#
..#..#..
..#..#..
#......#
#......#
###..###