###..###
#......#
#.#..#.#
#.......
#.......
#.#..#.#
#......#
###..###