###..###
#......#
#..##..#
........
........
#..##..#
#......#
###..###