###..###
#......#
#..#...#
...#...#
....#..#
#...#..#
#......#
########