###..###
#......#
#..#...#
#..#....
#...#...
#...#..#
#......#
########